30, 16
##############################
#                            #
#                            #
#                    #####   #
#            @               #
#                           ##
#                            #
#                       ##   #
#                            #
#                           ##
#                            #
#                       ##   #
#                            #
#                           ##
#                           ##
##############################