40,20
~

~
########################################
#                   ##                 #
#                   ##                 #
#                   ##                 #
#                   ##                 #
#                   ##                 #
#                   ##                 #
#                                      #
#                                      #
#                       ###            #
#                    ######            #
#                                      #
#               ###                    #
#                                      #
#                    ##                #
###    ###           ##                #
#        ###      #####                #
#                                      #
#   @         ##                       #
########################################