7,7
~
3,3
~
1,MG_cave-wall
2,dirt-center
3,dirt-grasstop
~
1,1,1,1,1,1,1
1,1,1,1,1,1,1
1,1,1,1,1,1,1
1,1,1,1,1,1,1
1,1,1,1,1,1,1
1,1,1,1,1,1,1
1,1,1,1,1,1,1
~
2,2,2,2,2,2,2
2,0,0,0,0,0,2
2,0,0,0,3,3,2
2,0,0,0,0,2,2
2,0,0,0,0,0,2
2,3,3,0,0,0,2
2,2,2,3,3,3,2