7,7
~
2,5
~
1,bluebox
2,darkpurplebox
3,greybox
4,dirt-grasstop
~
1,1,1,1,1,1,1
1,1,1,1,1,1,1
1,1,1,1,1,1,1
1,1,1,1,1,1,1
2,2,2,2,2,2,2
2,2,1,1,1,2,2
2,2,2,2,2,2,2
~
3,3,3,3,3,3,3
3,0,0,0,0,0,3
3,4,0,0,0,0,3
3,0,0,0,0,0,3
3,0,0,0,0,0,3
3,0,0,4,4,0,3
3,4,4,3,3,4,3