10,10
~
1,8
~
1,bluebox
2,dirt-grasstop
3,dirt-center
~
0,0,0,0,0,0,0,0,0,0
0,0,0,0,0,0,0,0,0,0
0,0,0,0,0,0,0,0,0,0
0,0,0,0,0,0,0,0,0,0
0,0,0,0,0,0,0,0,0,0
0,0,0,0,0,0,0,0,0,0
0,0,0,0,0,0,0,0,0,0
0,0,0,0,0,0,0,0,0,0
0,0,0,0,0,0,0,0,0,0
0,0,0,0,0,0,0,0,0,0
~
1,1,1,1,1,1,1,1,1,1
1,3,3,3,3,3,3,3,3,1
1,3,0,0,0,0,0,0,3,1
1,3,0,0,0,0,2,2,3,1
1,3,0,0,0,0,0,0,3,1
1,3,2,0,0,0,0,0,3,1
1,3,0,0,0,0,0,0,3,1
1,3,0,0,2,2,0,0,3,1
1,3,2,2,2,2,2,2,3,1
1,1,1,1,1,1,1,1,1,1