20,20
####################
#                  #
#                  #
#                  #
#                  #
#                  #
#                  #
#                  #
#                  #
#                  #
#                  #
#                  #
#                ###
#  @               #
#                  #
#     ###          #
#                 ##
#                  #
#  ##        ##    #
####################