20,20
####################
#                  #
#                  #
#                  #
#                  #
#                  #
#                  #
#                  #
#                  #
#                  #
#                  #
#                  #
#                  #
#  @               #
#                  #
#     ##           #
#                ###
#                  #
# ##       #       #
####################