20,20
####################
#                  #
#                  #
#                  #
#                  #
#                  #
#                  #
#                  #
#                  #
#                  #
#                  #
#                  #
#                  #
#                  #
#                  #
#                  #
#     ##         ###
#                  #
# ##  @    #       #
####################