20,20
####################
#                  #
#                  #
#                  #
#                  #
#                  #
#                  #
#                  #
#                  #
#                  #
#                  #
#                  #
#                  #
#  @              ##
#                  #
#                  #
#     ####       ###
#                  #
#  ##        ##    #
####################